


                   33                                                                            33
                     3                                                         11        1111      3                                                         1111
                11                           33      1122                   111       1111                                    22                         11111       
              11111111112  2   2           2     1111111111111           12  22 2  11111          22         112         11111111111111111     2      111111     2222
111111 1111111111111111111111111    1111111111111111111111111        111111111111111111111111111111111  1111111111111111111111111111111111111111111111111111111111111111111111111111111111111
111111 11111111111111111111111111                                  11111111111111111111111111111111111  1111111111111111111111111111111111111111111111111111111111111111111111111111111111111
111111 1111111111111111111111111111                           1111111111111111111111111111111111111111  1111111111111111111111111111111111111111111111111111111111111111111111111111111111111
111111 11111111111111111111111111111111111111111111111111111111111111111111111111111111111111111111111  1111111111111111111111111111111111111111111111111111111111111111111111111111111111111
