

                                                333                         
                                                111                         1111
                                          111                 333                      3     3     3
                  33            2     1111111                               333        
                  33        1111111111111111122      2       1   1          1111       2     2     2
111111111111112         11111111111111111111111111111111111111   111111111111111111111111111111111111111
11111111111111111111111111111111111111111111111111111111111111   111111111111111111111111111111111111111
11111111111111111111111111111111111111111111111111111111111111   111111111111111111111111111111111111111
11111111111111111111111111111111111111111111111111111111111111   111111111111111111111111111111111111111
